# # # # # # # # #
# o . # . . . o #
# . . . . . . . #
# # # # E # # # #
# . . # . . . . #
# . B . . . # . #
# . . . . . # . #
# o . . . . # o #
# # # # # # # # #